####################
#S.#............#G.#
#..#............#...
#..B....#.......C.T.#
#..#....#.......#.#.#
#..#....######.#.#..#
#..#............T...#
#..#######..####.#..#
#...................#
####################
