####################
#S.....#........#G.#
#..B...#........C#..#
#..#....#.........#.#
#..#....#.........#.#
#..#....######.#.#..#
#..#............T#..#
#..#######..####.#..#
#...................#
####################
