####################
#S..............B..#
#..................#
#.C..T.............#
#..................#
#..B...............#
#..........T.......#
#...C..............#
#.................T#
#..................#
#......B...........#
#....C.T.....B.....#
#..............T...#
#..................#
#BC................#
#....C.............#
#...T.......T......#
#..B............C..#
#.T.......C.......G#
####################
