####################
#S...............B.#
#...............B..#
#...............T..#
#......C...B....C..#
#....C..B..........#
#........C.........#
#............B.T...#
#.......C..C.......#
#...B.............B#
#..................#
#..........B.......#
#..................#
#..................#
#..B..T.B....C.....#
#B.............TT..#
#.................B#
#..TB....B.........#
#........B........G#
####################
