####################
#S...............T.#
#..................#
#.....B............#
#................C.#
#..B.........TT.T..#
#T.....B...........#
#..................#
#..................#
#.......B......T...#
#..................#
#....BC............#
#.......T..........#
#.........C.T.T....#
#.....TCT.....T..B.#
#......T......B....#
#.................T#
#B.................#
#..............T..G#
####################
