####################
#S.................#
#.........B...C....#
#.................T#
#.................B#
#..T..........B....#
#.C.C..C...........#
#.....C............#
#..................#
#..................#
#..B....B..........#
#..................#
#..................#
#..T...............#
#......B...........#
#....T............B#
#..........T.......#
#..................#
#...C.............G#
####################
