####################
#S.................#
#.B................#
#...............B..#
#..................#
#B......B..........#
#.C...............B#
#........T.........#
#..................#
#........C....B....#
#..................#
#.B................#
#.........T........#
#.........B........#
#...B..............#
#..................#
#.................T#
#.........B........#
#......B...C......G#
####################
