####################
#S.................#
#..................#
#..........B.......#
#..........B...B...#
#..C...............#
#..................#
#..................#
#.T........T.......#
#...............C..#
#..................#
#...C..T.......T...#
#......T.........B.#
#..................#
#..............T...#
#.........T.......T#
#.B..B..B.C.....C..#
#..................#
#...T............BG#
####################
