####################
#S...T........BB...#
#..................#
#....B.....B...B...#
#................T.#
#.................B#
#....B..B....T...T.#
#....B........C....#
#.......C........T.#
#.C......C.........#
#..................#
#..................#
#......B.T....CT...#
#............BT....#
#...............C..#
#......B.......C...#
#..................#
#..................#
#.......C.......C.G#
####################
