####################
#SC..T.............#
#...............B..#
#...BC....B......B.#
#C.T...............#
#........T.........#
#.....T............#
#................B.#
#..................#
#..B....B..........#
#..C..............B#
#.........B........#
#..................#
#..................#
#..........C.C..T..#
#...T....T.........#
#...........T......#
#.......C.......T..#
#.................G#
####################
