####################
#S...B.............#
#.......C...T......#
#................C.#
#..................#
#B.................#
#B.........C.T..B..#
#..........B.C...C.#
#.....TC...........#
#T.................#
#..T.B...B.........#
#......C...........#
#..................#
#...BB.............#
#...........B......#
#..B.............C.#
#..................#
#.....B...T........#
#....T......C..B..G#
####################
