####################
#S..........T......#
#........B...B..C..#
#............T.....#
#.............B...C#
#..................#
#....B..C..........#
#....T..B..........#
#..........B.......#
#..................#
#...T......C.......#
#......T...........#
#......C...........#
#.B........B.......#
#..................#
#......B...........#
#..................#
#..............B..B#
#..T..............G#
####################
