####################
#S.................#
#..................#
#..........BT......#
#..................#
#..................#
#..................#
#.....T..T.B.......#
#.....B............#
#B.................#
#...........B....C.#
#.........B........#
#..................#
#.............C....#
#.........T........#
#B.................#
#............B....T#
#....B........T....#
#...........B.....G#
####################
