####################
#S.T........C......#
#.....B.......T....#
#..................#
#..................#
#..........B.......#
#.............B.C..#
#....B...T....T....#
#..................#
#..................#
#..................#
#...B.......C.....B#
#...............B.C#
#...B.....B......B.#
#......T..B...C....#
#..................#
#...T..............#
#..................#
#.................G#
####################
