####################
#S.................#
#.............C....#
#............B.....#
#..................#
#..................#
#.........B........#
#..................#
#..................#
#.....B..BB........#
#..................#
#..................#
#B.................#
#...T.......B......#
#..................#
#............BT....#
#...............B..#
#..................#
#.........T.......G#
####################
