####################
#S.................#
#......B....C.T....#
#............B.....#
#.....C..C......C..#
#B.C...T...........#
#..............C...#
#..........TB......#
#..................#
#..................#
#.....B............#
#......B...........#
#C..BT.............#
#..................#
#.T......BB.....BB.#
#...........B......#
#......C...T..B...C#
#T.....B......T....#
#..B....B.........G#
####################
