####################
#S..T........T.....#
#.T................#
#.....B............#
#...T............C.#
#.................B#
#..................#
#............T....T#
#...............B..#
#..C......BC.......#
#......C.........T.#
#....T.....B..BB...#
#.......T..........#
#.....C.TB.........#
#.T.B......B.......#
#......T...B.......#
#..........T.......#
#...B....B.......CC#
#.................G#
####################
