####################
#S.................#
#.........T........#
#B.................#
#...........C......#
#.............C....#
#..................#
#............B.....#
#.......T..........#
#..B.............B.#
#C..........T.C....#
#..................#
#.TB.T.............#
#B.B...B...........#
#...........C......#
#C.................#
#...........C......#
#..................#
#.................G#
####################
