####################
#S.......T.....T...#
#.....#...T........#
#......C.....B.B..C#
#.................B#
#................C.#
#.......B..........#
#...B.............C#
#.............C....#
#..................#
#B.................#
#........CB........#
#....C........C....#
#...C..........B...#
#..................#
#..................#
#C.................#
#....B.............#
#......B..........G#
####################
