####################
#S.........T.......#
#..................#
#.......T..........#
#..................#
#...B..............#
#........T....BC...#
#................T.#
#..................#
#....B....T........#
#..................#
#..................#
#..T...............#
#......B..C....B..B#
#.........T........#
#..........C.....T.#
#B.....B.......C...#
#..................#
#...............B.G#
####################
