####################
#S........B........#
#...........BC.T...#
#.........C........#
#..........C.B.....#
#.........C.....B..#
#..C...............#
#.....C.....C.....B#
#.......B.C........#
#..................#
#...T..............#
#..................#
#.....B.T..........#
#...T.C............#
#...B..............#
#..........B.......#
#...BB..C..........#
#..........B.......#
#.................G#
####################
