####################
#S.................#
#.......C..........#
#..........T..B....#
#................B.#
#T.................#
#...............T..#
#C...B.............#
#..................#
#..................#
#.............C....#
#...B..............#
#........BB........#
#..B........CB....C#
#..B...............#
#..................#
#..................#
#.................T#
#.................G#
####################
