####################
#S.................#
#........C.........#
#..................#
#B..............B..#
#.....BC...........#
#..................#
#..................#
#......BB..........#
#.............BT...#
#..................#
#.B.......T........#
#...............C..#
#B.................#
#...........C......#
#.B.C..............#
#..................#
#.................B#
#.................G#
####################
