####################
#S.................#
#..................#
#....B.......T..B..#
#..................#
#................BB#
#T.B...............#
#.......T.B........#
#.......T......T...#
#..................#
#..................#
#.....C............#
#......B...........#
#..................#
#.............C...B#
#B.........C.......#
#.C................#
#.........B........#
#.................G#
####################
