####################
#S.................#
#.......C........T.#
#....C......B......#
#.............C....#
#.......B........T.#
#..................#
#.................B#
#..................#
#..........T.......#
#..B...............#
#.................B#
#...............T.T#
#......BB..........#
#..T.......B.......#
#..................#
#.........B...C....#
#.B....B.C.........#
#.................G#
####################
