####################
#S....B..B.........#
#...T..............#
#...T.C....B...B...#
#..................#
#............C.....#
#..................#
#.........T........#
#.......C..........#
#..................#
#B.................#
#.....T............#
#............T.TB..#
#..................#
#...........B......#
#...C...BC......BT.#
#.....B............#
#..................#
#.................G#
####################
