####################
#S.................#
#..................#
#.............T...T#
#..................#
#..................#
#..T.......C..B....#
#...............T..#
#.....B........C...#
#..................#
#..................#
#..................#
#.........C......B.#
#..................#
#...B..............#
#..................#
#.T............B...#
#C.................#
#....T...........BG#
####################
