####################
#S.................#
#...........B......#
#......C.B.........#
#........C.........#
#..................#
#B.................#
#........B.B.......#
#......T..........B#
#..........C......T#
#..B..B............#
#..................#
#.B.............B..#
#.................B#
#.......B..........#
#C............T....#
#..T.......T..T..C.#
#..C...............#
#.................G#
####################
