####################
#S..............B..#
#.....C.CB.B.......#
#......B........T..#
#......C.....T....B#
#...B.......B......#
#....B..........C..#
#...............C..#
#.........C........#
#..................#
#....T..........B..#
#.............B....#
#..................#
#.......C..........#
#.................B#
#...C..............#
#T...T............T#
#..................#
#...C....T.B......G#
####################
