####################
#S.T...............#
#B.................#
#.....C.........C.B#
#T.................#
#.............B....#
#.........B........#
#.....BC...........#
#...............B..#
#.T......C...C.....#
#.........B........#
#.................C#
#...........B......#
#.B...........B....#
#..................#
#.........B........#
#...T.B............#
#..............TB..#
#.................G#
####################
