####################
#S.....B...........#
#............T.....#
#.................B#
#.......T.T...T.B..#
#.............C....#
#..T.......B...B...#
#......CB..........#
#........T....TT...#
#.............C..TC#
#........T........T#
#..................#
#..................#
#..................#
#..................#
#............B...B.#
#...........B......#
#..................#
#........B...T....G#
####################
