####################
#S.............T...#
#.T................#
#......B....C......#
#...........B......#
#..................#
#...C.......B......#
#......C.TB........#
#.B..C.............#
#.B...BB...........#
#.......T..........#
#..T...............#
#C.................#
#..................#
#..................#
#..................#
#......B..B.T....B.#
#..................#
#.....B........B..G#
####################
